accession,A3,T3,C3,G3,BP,GC3_content
CP003350,79690,157008,415500,393627,1045825,77.367
CP001678,279725,347818,202146,202400,1032089,39.197
CP006914,74994,73783,61782,58998,269557,44.807
CP003096,151123,142938,140619,161276,595956,50.657
CP000655,165483,231452,139844,132421,669200,40.685
FP929048,170248,203208,44289,41710,459455,18.718
CP000481,62923,88972,314342,266229,732466,79.263
CP002453,514685,564793,170375,182600,1432453,24.641
CP007201,253941,328202,208633,186455,977231,40.429
AP012200,187636,198789,43790,59427,489642,21.08
CP001785,83593,90486,224410,234359,632848,72.493
CP007128,37531,48358,801531,744697,1632117,94.738
CP000747,28669,40052,622628,493576,1184925,94.2
CP002280,110667,188972,213721,200783,714143,58.042
CP001013,62276,78580,749841,615734,1506431,90.65
HE983995,84529,94088,36462,39896,254975,29.947
CP000252,163197,211478,293057,276391,944123,60.315
LN614830,290298,353691,175876,174864,994729,35.26
CP006955,220990,254295,125560,130254,731099,34.99
CP000478,155312,181345,551530,486927,1375114,75.518
CP001843,226105,293099,386466,341439,1247109,58.367
CP002629,147973,201507,303110,275683,928273,62.352
CP001681,414397,502628,335731,345631,1598387,42.628
AP012304,114297,138559,726393,573435,1552684,83.715
CP003346,371833,433257,413124,398961,1617175,50.216
CP002042,99445,112645,392840,349074,954004,77.768
CP003203,158778,190873,622510,449705,1421866,75.409
CP003653,477754,579448,168596,164468,1390266,23.957
CR767821,122137,135544,22201,35603,315485,18.322
CP002691,518507,632342,745001,576533,2472383,53.452
CP001814,109010,117298,1550081,1196179,2972568,92.387
CP006778,116679,104398,17233,15359,253669,12.848
AP012492,192200,247416,107281,131911,678808,35.237
CP011052,218475,322686,423114,401831,1366106,60.387
AE015928,460428,568257,412735,428775,1870195,44.996
CP002039,117288,165865,745167,596759,1625079,82.576
CP000141,203275,225026,131259,160796,720356,40.543
CP000792,181661,188700,136538,108659,615558,39.833
AP010968,63499,39638,1431110,1018858,2553105,95.96
AP008230,322737,444913,424946,425778,1618374,52.567
CP000116,61596,70730,436651,328591,897568,85.257
CP004856,279977,283044,219604,215280,997905,43.58
CP001707,211158,285852,179690,179256,855956,41.935
CP001992,104638,144018,193400,201911,643967,61.387
CP002347,212600,240704,92822,125920,672046,32.549
FQ312005,328328,409754,157548,169364,1064994,30.696
CP010803,95492,179347,589903,441756,1306498,78.964
CP000383,405967,448987,235273,242723,1332950,35.86
CP007446,180481,254697,117055,145827,698060,37.659
CP000679,300377,297342,110793,152346,860858,30.567
CP002701,80276,84210,9542,12793,186821,11.955
CP001087,314842,411837,492918,411501,1631098,55.448
CP000157,86424,116215,406194,322328,931161,78.238
CP003281,397528,427080,192504,205982,1223094,32.58
CP001896,73866,129675,474474,394916,1072931,81.029
CP006650,74971,164863,446733,397632,1084199,77.879
CP003147,259033,405701,472924,429511,1567169,57.584
CP005990,46726,92294,244566,219752,603338,76.958
AL935263,216689,293211,196742,223109,929751,45.157
CP003130,215323,334730,686372,580513,1816938,69.726
CP003075,110929,178839,496458,385525,1171751,75.271
AP009552,449334,515551,331300,288544,1584729,39.114
CP009301,339159,359835,149499,153174,1001667,30.217
AM260525,184907,262580,89170,110427,647084,30.846
CP001674,127188,194245,305216,283852,910501,64.697
CP009706,252022,361294,337306,348034,1298656,52.773
HF951689,171170,242537,322736,288128,1024571,59.621
CP003171,83543,141766,424901,388533,1038743,78.309
CP008802,48487,83662,202061,163721,497931,73.46
CP011265,100237,154184,508539,281166,1044126,75.633
CP000927,73110,116224,810969,610596,1610899,88.247
CP001818,36304,45096,230969,255654,568023,85.67
CP000264,116773,193974,514212,481060,1306019,76.207
CP009415,224523,230028,61818,58077,574446,20.871
CP001619,353453,395082,719922,624182,2092639,64.23
CP001834,255170,307686,90193,97977,751026,25.055
CP007519,78143,114733,269449,210422,672747,71.33
CP002432,103368,167182,333202,254335,858087,68.471
CP002961,470825,550120,206228,200515,1427688,28.49
CP003389,106393,140577,1406886,1428726,3082582,91.988
CP009291,91575,134890,489878,374277,1090620,79.235
CP000360,209788,263555,648536,563403,1685282,71.913
CP010049,70353,87819,11451,20365,189988,16.746
CP002131,162875,143168,178247,177900,662190,53.783
CP001875,205863,326017,409390,435124,1376394,61.357
AP009179,188882,207925,192460,181730,770997,48.533
AP009178,179824,188102,111214,110375,589515,37.588
CP000859,144299,202192,438169,376234,1160894,70.153
CP001032,128788,180350,758685,692473,1760296,82.438
CP001874,26429,29998,610580,499669,1166676,95.163
CP002976,122167,210799,397787,394055,1124808,70.398
AP012333,53964,83419,240354,170088,547825,74.922
CP002999,307584,340889,266396,242622,1157491,43.976
CP001966,78977,104885,648224,519108,1351194,86.393
CP003058,120603,191282,226825,177913,716623,56.479
CP001823,42218,58041,368123,318760,787142,87.263
CP002825,419056,402121,102460,83754,1007391,18.485
CP006866,243601,231022,233661,228456,936740,49.332
CP000232,113538,145974,269428,230720,759660,65.838
CP000377,99922,166860,354770,328406,949958,71.916
CP001618,38257,45933,750185,607319,1441694,94.16
CP002171,296209,279211,93051,129733,798204,27.911
CP002521,85740,95110,797671,676408,1654929,89.072
CP005964,199143,264764,201430,210020,875357,47.004
HE804045,92584,78861,1363363,1261404,2796212,93.869
CP001726,66437,84123,493611,411999,1056170,85.745
FR872580,281639,324950,157896,153699,918184,33.936
CP000422,171997,208600,76029,83067,539693,29.479
CP001819,38250,44641,719603,476114,1278608,93.517
CP008803,93829,117301,343412,294776,849318,75.141
CP006958,104217,119706,952641,790944,1967508,88.619
CP002018,70930,136533,307198,288488,803149,74.169
CP001634,200313,202355,138517,137180,678365,40.641
CP000875,363278,531355,507790,460048,1862471,51.965
FP929045,76871,117331,345348,252742,792292,75.489
CP000930,118230,141326,349833,276924,886313,70.715
FM178379,271014,324068,132648,138773,866503,31.324
CP006734,37093,50609,358738,272297,718737,87.798
AP009380,135016,169771,198688,172460,675935,54.909
AP012554,94312,113093,24494,29836,261735,20.758
AE017282,88320,108431,433640,356603,986994,80.066
CP000910,162413,211111,300223,276344,950091,60.685
CP006597,318061,320051,136244,142643,916999,30.413
CP003280,348779,380539,172428,150497,1052243,30.689
CP007447,325935,329387,88801,103746,847869,22.71
CP007152,119340,171318,310477,285338,886473,67.212
CP000414,191608,229625,81022,101003,603258,30.174
CP006939,205239,261511,336064,315314,1118128,58.256
BA000026,166795,182530,28922,23590,401837,13.068
FP929032,94750,102534,375492,295219,867995,77.271
CP007451,378155,420866,293518,288970,1381509,42.163
CP003557,284477,277056,249740,202990,1014263,44.636
CP001643,25724,38545,582617,431344,1078230,94.039
CP001706,137384,168187,296703,226738,829012,63.14
AP012057,105785,104439,781801,503484,1495509,85.943
AP007255,78738,140249,700803,543065,1462855,85.03
CP002038,178989,259450,469952,512300,1420691,69.139
AP006628,81636,84313,27638,14345,207932,20.191
CP001614,285372,379442,433873,401153,1499840,55.674
HG530068,138135,158017,1000501,775614,2072267,85.709
CP011301,102788,130105,795045,763351,1791289,86.999
CP000510,330901,426091,210443,223604,1191039,36.443
CP000140,291877,404081,352701,402473,1451132,52.04
CP002690,203101,219495,69048,84855,576499,26.696
CP008788,215856,350144,603708,605895,1775603,68.124
AP011529,252258,286943,57277,93990,690468,21.908
CP002106,33247,56403,303521,202284,595455,84.944
CP000750,30476,31652,807878,570954,1440960,95.688
LN614827,382680,459081,178427,196486,1216674,30.815
AP012978,47551,68959,328745,276107,721362,83.849
CP002628,60490,95051,254090,206156,615787,74.741
CP000245,41113,47953,620037,544807,1253910,92.897
CP003255,117040,131628,468882,487844,1205394,79.37
CP002444,100125,92029,184579,155771,532504,63.915
CP000316,139141,191583,637295,564335,1532354,78.417
CP001854,62720,55186,1036928,833155,1987989,94.069
CP002281,221957,195666,69029,94466,581118,28.135
AP010953,308109,430386,436790,485185,1660470,55.525
CP000879,243758,218225,90667,94579,647229,28.621
AP013105,45615,88077,404062,297532,835286,83.994
CP002452,87521,107715,249113,187173,631522,69.085
CP002901,167795,212585,313241,356493,1050114,63.777
CP001100,217454,269986,238875,225244,951559,48.775
AP010904,136969,174672,720517,490573,1522731,79.534
FO538765,130249,196770,482092,404638,1213749,73.057
CP007030,155146,210315,134855,153210,653526,44.079
CP001737,68788,85291,880355,749720,1784154,91.364
AP009153,128297,199187,550508,546034,1424026,77.003
HE999757,378703,407722,111504,142091,1040020,24.384
CP006949,99321,126175,111103,102494,439093,48.645
AP014624,500175,565796,238139,253243,1557353,31.552
CP001275,69228,90133,234759,207994,602114,73.533
CP004348,146370,210704,139563,136708,633345,43.621
CP002273,252190,332505,376813,340593,1302101,55.096
CP002623,188949,273262,444340,444733,1351284,65.795
BX908798,224412,260519,87018,90692,662641,26.818
CP003198,151707,151341,175498,178600,657146,53.884
CP008804,141105,200653,103829,103995,549582,37.815
CP002859,411818,490500,538953,475000,1916271,52.913
FP929054,266440,295058,174840,217181,953519,41.113
CP002361,26208,23646,373834,288449,712137,92.999
CP003989,82361,104679,474496,456451,1117987,83.27
CP006772,219063,250970,167707,178589,816329,42.421
AP012027,177790,208920,69459,78313,534482,27.648
CP002224,71451,137873,311885,292600,813809,74.278
CP001721,89870,180623,97231,92338,460062,41.205
CP002048,142109,150192,183651,212316,688268,57.531
CP003659,564332,632236,261668,257478,1715714,30.258
CP000976,107353,132672,18356,31608,289989,17.23
CP010327,425988,442584,138534,183449,1190555,27.045
CP002930,209102,309474,345325,335386,1199287,56.76
CP003788,82591,95847,871205,631922,1681565,89.389
CP010848,60815,106691,219527,179359,566392,70.426
LK028559,192409,194963,49888,49395,486655,20.401
AP008955,429833,471705,428007,503800,1833345,50.826
CP001998,174999,264505,364083,320678,1124265,60.907
CP003360,385486,425236,497547,480145,1788414,54.668
CP002422,113703,114681,219722,148419,596525,61.714
AP012334,92728,173735,129978,129882,526323,49.373
CP004372,64759,111520,447946,395473,1019698,82.713
AP014521,84272,89011,10223,13103,196609,11.864
CP003264,169146,214997,65559,79082,528784,27.354
CP000448,196719,236763,178797,201628,813907,46.741
CP002547,213974,263714,248717,264870,991275,51.811
CP001804,115009,174122,1447668,1045203,2782002,89.607
CP001279,196577,182710,71303,70532,521122,27.217
CP001629,127137,171475,495964,382556,1177132,74.632
CP002455,236863,227311,106672,103114,673960,31.127
CP000038,241600,339973,357134,399121,1337828,56.529
CP010311,108197,175858,346700,289934,920689,69.148
CP001280,102848,170557,528345,424277,1226027,77.7
CP011280,178231,143341,26061,35633,383266,16.097
CP002156,93544,158716,331246,291358,874864,71.166
CP001146,221007,236041,60126,92831,610005,25.075
HF563609,273310,271338,118930,141492,805070,32.348
FP475956,97193,137365,487574,419943,1142075,79.462
FQ859181,174988,246094,543561,456366,1421009,70.367
CP003985,273946,385869,279967,253071,1192853,44.686
AM743169,93034,135936,638868,570414,1438252,84.08
CP002382,108369,160688,242858,234303,746218,63.944
CP006569,155615,244351,438640,450252,1288858,68.967
CP007051,207691,203813,60001,61152,532657,22.745
CP001185,252290,235225,51426,70549,609490,20.013
AP012050,262815,272745,84043,106656,726259,26.258
CP009761,182873,188123,29571,47853,448420,17.266
CP006617,91864,128087,51426,82908,354285,37.917
CP003415,267758,381106,385027,432527,1466418,55.752
CP000393,560554,631043,181281,231599,1604477,25.733
CP003946,348316,478903,291690,274777,1393686,40.645
AP014583,421008,484577,116576,128720,1150881,21.314
FM162591,362125,487262,244761,298728,1392876,39.019
CP000686,201782,301059,556050,583567,1642458,69.385
CP002584,506564,588898,359570,382316,1837348,40.378
AP012338,28497,32194,600118,465298,1126107,94.611
AP012292,134885,217825,261143,282302,896155,60.642
CP003403,232982,344908,411122,433663,1422675,59.38
CP003546,56648,72638,57150,57939,244375,47.095
CP007155,114186,119344,1438933,1297463,2969926,92.137
CP002479,123565,135973,706659,564357,1530554,83.043
FP929062,170855,194831,236398,255500,857584,57.359
AP012046,253472,280212,93402,109648,736734,27.561
CP000628,97625,178545,501683,380282,1158135,76.154
CP005996,229662,273469,141096,153827,798054,36.955
CP005094,98917,126965,741968,574054,1541904,85.35
CP002028,210445,248692,209079,232685,900901,49.036
AP011112,150628,148076,119454,139791,557949,46.464
CP001080,226823,183268,58605,62283,530979,22.767
CP010557,164555,280015,575345,562841,1582756,71.912
HF571988,294374,413897,315282,348151,1371704,48.366
CP001429,81759,83311,15167,20166,200403,17.631
CP003947,374435,446668,149292,140904,1111299,26.113
CP000238,72488,85504,17691,21264,196947,19.779
CP007142,365790,538274,474025,498224,1876313,51.817
CP001096,106791,164170,739352,644986,1655299,83.631
CP002593,58407,65236,1109471,870267,2103381,94.122
CP003382,103972,130743,483094,404628,1122437,79.089
CP001700,143114,159810,1548885,1249560,3101369,90.233
CP000812,219680,220293,104107,123527,667607,34.097
CP002985,132775,203023,311960,302946,950704,64.679
CP010812,254070,337857,283805,296558,1172290,49.507
CP001184,108136,123979,17416,13575,263106,11.779
FO117623,45736,53784,760023,613623,1473166,93.244
AP012051,171618,178994,63709,69099,483420,27.473
CP006704,151296,240016,721918,633697,1746927,77.6
CP003156,337868,432241,224596,225289,1219994,36.876
CP006587,102539,132806,622851,489964,1348160,82.543
CP000453,49280,84812,454246,401349,989687,86.451
AP012495,535709,623763,521613,523411,2204496,47.404
CP001110,168986,251413,229722,214008,864129,51.35
CP003984,164240,240144,287671,287746,979801,58.728
CP001055,148098,156402,105592,87383,497475,38.791
CP003592,243653,353247,279716,306403,1183019,49.544
CP001686,23913,34818,426123,346094,830948,92.932
CP002045,109077,148186,166214,152174,575651,55.309
CP003879,404534,452303,176004,169249,1202090,28.721
CP007139,170445,202688,634428,527548,1535109,75.693
CP001147,240242,237728,65046,82282,625298,23.561
CP004345,187041,276733,302358,334983,1101115,57.881
CP000613,41274,73783,617169,542487,1274713,90.974
CP001281,60071,79735,686994,515796,1342596,89.587
CP003746,187702,259821,444480,408964,1300967,65.601
CP004083,269720,388362,334635,349954,1342671,50.987
CP002157,364173,427478,179390,201300,1172341,32.473
CP010310,109560,154893,637013,581852,1483318,82.172
CP002287,144435,166223,994270,833541,2138469,85.473
CU207366,356373,429855,163389,196042,1145659,31.373
CP002638,86656,99569,978514,796322,1961061,90.504
CP003183,102021,187957,271060,289418,850456,65.903
AP012342,144730,199882,201931,201521,748064,53.933
CP001628,16357,20913,406486,303876,747632,95.015
CP002395,81322,136797,286123,257245,761487,71.356
CP001940,90640,133144,368774,320081,912639,75.479
CP000828,412548,547617,443963,429144,1833272,47.626
CP002116,278949,401400,400577,361883,1442809,52.846
CP002546,264885,331063,589539,530379,1715866,65.268
CP003642,555681,619498,360547,358691,1894417,37.966
CP000449,86931,159256,430338,334397,1010922,75.647
AP013066,130670,174440,335499,303880,944489,67.696
AP009484,206042,218632,82380,108924,615978,31.057
CP001034,323143,331885,120162,136805,911995,28.176
AM999887,149461,150865,45089,60995,406410,26.103
FP929038,212354,286494,166522,227745,893115,44.145
CP002835,293093,286979,215847,270676,1066595,45.615
CP000388,381350,454702,349264,311430,1496746,44.142
CP001825,153807,168234,138965,156334,617340,47.834
AP014648,82693,123997,434079,359766,1000535,79.342
CP002209,111358,194490,509630,455694,1271172,75.94
CP003418,392229,451435,138899,144728,1127291,25.16
CP001560,148957,243180,406908,423096,1222141,67.914
CP001130,186537,165242,70887,71984,494650,28.883
CP001999,422474,417718,60889,84324,985405,14.736
CP002198,523079,607372,300089,280329,1710869,33.925
CP003273,301338,364831,304927,333414,1304510,48.933
CP003789,124801,175353,41702,57367,399223,24.815
CP002874,380287,403264,67150,84490,935191,16.215
CP000849,152376,168825,38729,49370,409300,21.524
CP001472,115649,198893,468424,434476,1217442,74.164
CP002049,52410,65357,468897,365649,952313,87.634
CP002360,255999,266984,186250,233000,942233,44.495
CP006773,107856,159810,459733,437983,1165382,77.032
CP002858,209194,246926,123856,141364,721340,36.768
CP001798,216453,303874,323270,326907,1170504,55.547
CP001632,219250,246759,160333,126149,752491,38.071
AP014633,400957,493537,245552,247837,1387883,35.55
CP000473,292086,386853,1256819,1077490,3013248,77.468
CP004349,359217,387231,82211,89910,918569,18.738
CP001848,260146,354886,625360,536781,1777173,65.393
AP009152,23938,30251,403315,337466,794970,93.184
CP003926,151344,269827,334269,324589,1080029,61.004
CP001736,84020,100100,1111754,978331,2274205,91.904
CP000961,408345,566010,358594,350651,1683600,42.127
CP001673,208208,241416,202724,182809,835157,46.163
FP565814,67286,93172,484721,411721,1056900,84.818
CP007031,46628,88834,538932,408279,1082673,87.488
CP002663,169967,228538,415344,364853,1178702,66.191
CP003422,252821,348956,869513,952112,2423402,75.168
CP002162,66284,68299,1068572,901539,2104694,93.606
CP002027,144304,151787,13974,14153,324218,8.675
AP012224,85815,104462,584105,492522,1266904,84.981
CP001037,650418,725208,386673,382780,2145079,35.871
CP001349,90283,155548,1045211,836039,2127081,88.443
AP012273,122608,185057,321016,300146,928827,66.876
CP009450,138541,235725,618636,568044,1560946,76.023
AP012320,53806,52939,809501,649239,1565485,93.181
CP003732,128162,166732,257182,272339,824415,64.23
BA000039,128364,195718,235117,217154,776353,58.256
CP001099,79047,110205,263852,212214,665318,71.555
CP003620,469515,525980,220251,241719,1457465,31.697
CP001867,36540,40557,806253,635535,1518885,94.924
CP006265,207791,301984,168088,174161,852024,40.169
CP007161,351160,360037,133824,185382,1030403,30.979
CP001631,45576,66285,298209,233125,643195,82.609
FP929056,27637,38609,188771,177460,432477,84.682
CP002158,199161,303431,362628,280253,1145473,56.124
CP002271,165906,243505,1374636,1335606,3119653,86.876
CP007566,96308,166018,617675,517797,1397798,81.233
CP003876,179244,203627,1293931,1082176,2758978,86.123
CP009217,196483,221486,42569,61403,521941,19.92
HE956757,97966,148925,475458,392888,1115237,77.862
CP000061,69214,70288,22444,11775,173721,19.698
CP003837,443358,520281,276382,264025,1504046,35.93
CP002725,133218,199289,77428,92436,502371,33.812
AP012551,135100,216009,374719,416581,1142409,69.266
AP012044,179322,251433,418819,411957,1261531,65.855
CP004393,79077,124308,615779,517844,1337008,84.788
CP000153,242438,262439,81990,94282,681149,25.879
CP000850,104118,126118,781379,662202,1673817,86.245
CP001312,60239,123771,461244,486353,1131607,83.739
CP001607,182531,209363,146090,131977,669961,41.505
CP002355,186831,225908,209360,180704,802803,48.588
CP003051,71664,107517,539150,407370,1125701,84.083
CP000387,155356,238438,151338,162515,707647,44.352
CP000554,161774,215887,196954,186459,761074,50.378
CP000411,137220,194852,84538,90215,506825,34.48
CP001650,472153,551741,225143,241056,1490093,31.287
CP003801,159627,189179,55032,50437,454275,23.217
CP002343,47556,59779,646040,456570,1209945,91.129
CP003944,310204,342839,192347,183482,1028872,36.528
CP002085,66931,84432,545841,403243,1100447,86.245
CP000542,133959,157966,740108,627981,1660014,82.414
CP010954,91606,153598,587940,528146,1361290,81.987
AP012547,99926,126253,523477,423091,1172747,80.714
CP003155,229367,299341,291913,254287,1074908,50.814
AP012052,49914,69828,644787,452828,1217357,90.164
CP007053,180642,244829,1070643,610639,2106753,79.804
FP236843,193515,310149,480727,507739,1492130,66.245
CP002528,346741,377758,142298,151467,1018264,28.85
AP012029,185521,248207,328385,327414,1089527,60.191
CP003591,143390,222961,488681,452555,1307587,71.983
CP007028,121365,109969,109641,126488,467463,50.513
CP000352,95551,132103,493484,463460,1184598,80.782
CP001810,278374,393756,187568,211442,1071140,37.251
CP010978,458611,550741,224052,292928,1526332,33.871
CP002046,334559,357126,106126,104147,901958,23.313
CP001685,285414,254109,49490,99615,688628,21.652
AE014184,62382,90782,52502,60628,266294,42.483
CP009962,220988,281890,571710,522215,1596803,68.507
CP006681,162088,155579,20758,23000,361425,12.107
CP002292,103543,151306,480354,404366,1139569,77.636
CP011144,37674,39919,525866,450496,1053955,92.638
CP003600,437258,501210,404165,349886,1692519,44.552
CP005384,196016,219332,104003,112111,631462,34.224
CP001778,126101,109622,1051402,801831,2088956,88.716
CP003315,89016,83967,14234,15308,202525,14.587
CP001851,68599,125804,217237,189423,601063,67.657
CP003495,45659,77983,478362,395286,997290,87.602
AP012204,111228,159824,774471,677944,1723467,84.273
CP002512,155565,199301,140869,106537,602272,41.079
CP003587,152024,221186,593529,457246,1423985,73.791
AP009389,148880,164560,281344,276243,871027,64.015
HE717023,319407,365719,205806,240875,1131807,39.466
CP007481,70178,80942,47327,54512,252959,40.259
CP002683,195015,232821,140299,123754,691889,38.164
CP002400,113925,147340,309933,282393,853591,69.392
CP001739,496324,422171,136375,212869,1267739,27.549
AM902716,128033,145739,718396,604667,1596835,82.855
CP000083,472107,586185,237456,223596,1519344,30.345
CP002544,304297,379072,279823,320371,1283563,46.76
CP001738,53517,53957,793033,677892,1578399,93.191
CP001807,82164,105178,409289,404666,1001297,81.29
CP002006,171658,297081,315620,294612,1078971,56.557
CP001016,136297,248190,419883,343644,1148014,66.509
CP006696,131564,188191,208351,205636,733742,56.421
CP000884,124211,161396,953767,788027,2027401,85.913
AM889285,80743,118501,511199,480579,1191022,83.271
CP000492,178504,247845,235335,220254,881938,51.658
CP001779,231388,201786,18379,39915,491468,11.861
CP002786,183628,223688,563077,474468,1444861,71.809
CP003178,603715,727258,694556,618463,2643992,49.66
CP001145,117377,129802,93127,100745,441051,43.957
CP002339,387989,467134,301927,277052,1434102,40.372
CP002417,119565,133520,966754,785819,2005658,87.381
CP002047,150732,170738,1758795,1363906,3444171,90.666
CP001684,80426,108603,417129,300564,906722,79.152
CP006842,87818,120430,486485,366541,1061274,80.378
AP014685,181240,288104,1230101,996404,2695849,82.59
CP002102,46298,75813,516981,409375,1048467,88.353
CP003590,368095,396754,332364,270202,1367415,44.066
CP003969,95011,145762,1853550,1603301,3697624,93.488
FO818637,314524,418956,284185,321031,1338696,45.209
CP003787,236009,249790,96004,106917,688720,29.463
CP000282,378604,426878,362114,295605,1463201,44.951
CP003154,123566,203364,602452,519294,1448676,77.432
AM942759,349383,433364,173957,184813,1141517,31.429
CP002084,78021,95435,178003,146041,497500,65.134
CP002987,316896,399533,202764,231040,1150233,37.714
HG322949,178107,197267,730528,654243,1760145,78.674
CP000685,627377,665990,245790,236493,1775650,27.161
CP001997,153572,190784,126713,127488,598557,42.469
CP000390,135628,208730,522745,450326,1317429,73.861
CP002657,73067,81767,739206,623668,1517708,89.798
CP003945,345174,399360,227807,218038,1190379,37.454
CP003379,163430,242328,604840,528615,1539213,73.639
CP002991,289845,263479,79634,116788,749746,26.198
CP003729,111561,93859,1543372,1289736,3038528,93.239
CP000555,52874,68162,598258,527021,1246315,90.288
CP002568,70888,104304,682554,516381,1374127,87.251
BA000022,224214,295828,271478,244819,1036339,49.819
CP008889,29541,44646,374131,267892,716210,89.642
AP012157,366258,355973,160158,206438,1088827,33.669
CP000386,36048,33564,479365,442642,991619,92.98
FP929061,297940,257382,109906,149605,814833,31.848
AP006840,41022,56350,470968,466659,1034999,90.592
CP007044,261697,381276,403450,450778,1497201,57.055
CP000781,72938,133290,764364,590519,1561111,86.79
AP009384,70662,149445,788001,601822,1609930,86.328
CP006272,105028,156315,1447073,1106892,2815308,90.717
CP008796,150574,155320,64946,77949,448789,31.84
CP001108,134894,196701,216736,191312,739643,55.168
CP001221,361850,398115,161646,162702,1084313,29.913
CP001364,217099,348363,431781,442537,1439780,60.726
CP003359,293703,320842,45143,105058,764746,19.641
CP001734,105212,146491,307042,254582,813327,69.053
CP002548,100502,98452,32068,19813,250835,20.683
CP003532,210410,223392,204961,204613,843376,48.564
CP000934,233192,349299,425265,375279,1383035,57.883
CP000758,109537,183790,285934,249491,828752,64.606
CP009129,314885,304817,142822,157359,919883,32.633
CP000471,192976,335194,393978,440974,1363122,61.253
CP000922,267520,251514,139839,180882,839755,38.192
CP001630,45981,44756,1194204,1120458,2405399,96.228
CP002159,162044,219481,276472,299637,957634,60.16
CP001958,77002,72123,438723,363886,951734,84.331
FO203355,216577,330808,520902,522100,1590387,65.582
CP000975,165362,199062,172351,155935,692710,47.392
CP009257,377166,477545,181999,195865,1232575,30.656
CP000830,68667,108397,499265,465238,1141567,84.489
CP001722,125175,205006,143156,138254,611591,46.013
CP000774,109929,164212,499968,402708,1176817,76.705
CP004388,191094,330180,434796,391764,1347834,61.325
CP006566,197452,283078,543861,556353,1580744,69.601
CP002876,262719,316266,232923,254951,1066859,45.73
CP002899,134391,162039,40716,66217,403363,26.51
CP011132,238411,359712,481442,515955,1595520,62.512
CP001098,214873,272701,114065,144615,746254,34.664
CP003949,181416,181250,1235210,944634,2542510,85.736
CP003119,124190,149038,815681,608626,1697535,83.904
CP003549,761794,851877,332512,334733,2280916,29.253
CP001962,54658,74379,315559,292377,736973,82.491
CP000109,191607,227380,143113,165901,728001,42.447
AP012337,181792,259594,554312,505490,1501188,70.598
CP009056,262724,315758,87072,98552,764106,24.293
CP002026,52896,100291,716839,538185,1408211,89.122
CP000769,33110,44167,817335,689370,1583982,95.121
CP002304,275815,308810,73219,98126,755970,22.666
CP003283,234737,229877,128115,125056,717785,35.271
CP000155,332214,436151,695180,661597,2125142,63.844
CP003796,108099,131709,56919,54528,351255,31.728
CP002353,171374,227229,651614,491083,1541300,74.139
AM494475,136567,151273,30428,42718,360986,20.263
CP007444,114375,170552,675374,578027,1538328,81.478
CP001713,107745,133632,66894,62697,370968,34.933
CP002345,308718,365380,193383,204039,1071520,37.09
HG934468,203980,259960,227654,238969,930563,50.144
CP009159,230588,249871,122545,131052,734056,34.547
CP000544,41180,72479,384692,323286,821637,86.167
CP003153,71665,94391,582793,398257,1147106,85.524
CP000285,81572,128126,489957,405655,1105310,81.028
CP003915,213156,316518,411397,421261,1362332,61.12
CP001928,172179,195708,149754,146447,664088,44.603
CP006644,100049,183297,855958,714842,1854146,84.718
CP000513,108877,132345,87818,91380,420420,42.624
AM180252,151753,176504,34099,40562,402918,18.53
AP008971,214451,187277,71754,71248,544730,26.252
CP003597,509753,544021,364550,344442,1762766,40.22
CP009460,159023,238706,460514,503618,1361861,70.795
CP002105,224263,271942,69955,132843,699003,29.012
CP001683,90037,94824,559362,504894,1249117,85.201
AP010946,40902,74822,455371,382411,953506,87.863
CP009122,123962,191361,662013,526935,1504271,79.038
AE000657,147258,103134,118428,113446,482266,48.08
CP002017,124499,163746,305743,377046,971034,70.316
CP003313,216236,243990,116860,125727,702813,34.517
CP001154,90921,117654,389293,330000,927868,77.521
CP003493,47522,60373,564614,407166,1079675,90.007
CP002902,90262,125395,344077,364623,924357,76.67
CP002514,90585,130499,301819,281906,804809,72.53
AP011615,490380,594256,378773,374295,1837704,40.979
CP002390,185179,174239,67933,98533,525884,31.655
CP002056,258604,307896,175644,177965,920109,38.431
FO203431,35055,40090,905477,722809,1703431,95.589
CP002955,544645,610111,313930,327150,1795836,35.698
CP002810,15910,18296,546670,417894,998770,96.575
AM711867,22397,22502,566051,376644,987594,95.454
CP002543,184676,178490,55063,60450,478679,24.132
CP000509,43891,51766,812146,614202,1522005,93.715
FO203503,401477,474328,319232,309706,1504743,41.797
CP003260,218321,200042,116252,118759,653374,35.969
CP003630,510315,614957,454260,473600,2053132,45.192
CP001820,184053,246216,94446,94094,618809,30.468
AP014821,406399,482950,141882,132249,1163480,23.561
CP001965,119974,136130,344856,317028,917988,72.102
CP003364,249467,337624,1147598,915789,2650478,77.85
CP003558,230282,308846,272565,253703,1065396,49.396
CP003108,429460,532040,334153,357548,1653201,41.84
CP002349,446010,496557,189437,210630,1342634,29.797
CP000724,474217,460440,188263,243035,1365955,31.575
HF680312,103815,135578,98736,93976,432105,44.598
CP009440,234476,285430,60443,82481,662830,21.563
CP001230,206823,204793,82846,114305,608767,32.385
AP011121,158683,246598,219487,243157,867925,53.305
CP001322,275126,309594,724197,578689,1887606,69.023
FP929050,293234,311139,198172,278353,1080898,44.086
CP006664,113820,207880,426266,444567,1192533,73.024
CP003466,134632,212411,583120,537518,1467681,76.354
CP003870,207590,251920,202824,216767,879101,47.73
HG938353,116285,183572,614283,465644,1379784,78.268
CP003470,69747,86735,590967,522602,1270051,87.679
CP000749,399781,521700,285476,289340,1496297,38.416
CP000319,112838,163919,494962,429960,1201679,76.969
CP002959,227137,278806,446819,383662,1336424,62.142
CP000088,82819,73545,507441,370724,1034529,84.885
CP001699,637430,759902,648180,645870,2691382,48.081
CP007034,129383,161389,327504,252941,871217,66.625
CP002666,21739,26375,684257,547640,1280011,96.241
AP012035,62351,104227,537192,439300,1143070,85.427
CP009495,138217,154000,1012014,818600,2122831,86.235
CP007035,307266,365638,318433,340275,1331612,49.467
CP002667,236975,280709,129268,149547,796499,35.005
CP003563,163990,244450,805272,633700,1847412,77.891
AM236080,126577,205195,644697,481618,1458087,77.246
CP004025,124495,182684,1414208,1431347,3152734,90.257
CP000089,151702,229853,556835,439938,1378328,72.318
CP010820,448303,473055,170264,221711,1313333,29.846
CP009302,30010,41403,219344,168872,459629,84.463
CP000820,125324,151660,1246066,995228,2518278,89.001
CP002630,40269,41398,319264,294244,695175,88.252
CP007062,342660,308169,32507,61982,745318,12.678
CP000031,84863,151673,514666,486048,1237250,80.882
FP929047,31206,38412,289169,233744,592531,88.251
CP003488,338685,419091,220052,230992,1208820,37.313
CP004121,750385,728861,116437,206605,1802288,17.924
AP009510,86469,87082,33774,42361,249686,30.492
CP002364,116886,170937,472943,371609,1132375,74.582
FR872582,214561,252693,163622,128979,759855,38.507
BA000012,165642,248793,909649,715462,2039546,79.68
CP003349,465875,562591,233389,253208,1515063,32.117
CU207211,168318,205378,322422,315626,1011744,63.064
CP009416,286395,321172,171047,227643,1006257,39.621
CP000267,151977,222073,542565,501322,1417937,73.62
HG315671,442229,474548,149292,147895,1213964,24.481
AE016825,95131,106486,634087,566644,1402348,85.623
AP014565,241175,356361,413032,454601,1465169,59.217
CP001071,108585,141250,285899,239767,775501,67.784
CP001708,198612,180412,97876,78539,555439,31.761
CP001821,31690,37152,607709,458467,1135018,93.935
CP000733,180072,212923,130329,131659,654983,39.999
CP002831,268201,373776,313018,285663,1240658,48.255
AP012331,49151,67865,441891,339189,898096,86.971
FO082060,270076,308219,366536,330372,1275203,54.651
BA000028,385198,374113,108371,154732,1022414,25.734
CP003236,55834,119082,534367,454465,1163748,84.97
CP000158,111051,173944,460541,373410,1118946,74.53
CP003646,454371,493552,283611,279800,1511334,37.279
CP002542,458614,510054,203015,220669,1392352,30.429
CP011047,158669,249901,446483,460894,1315947,68.952
CP001801,118518,169659,247518,229938,765633,62.361
AP014800,70953,131046,580432,523035,1305466,84.527
FP476056,418866,471301,430181,351491,1671839,46.755
CP007202,337805,376489,137696,112590,964580,25.948
CP000482,127226,159031,493680,402085,1182022,75.782
CP001769,426215,571201,702220,659410,2359046,57.72
AM420293,88656,87929,1154904,990467,2321956,92.395
CP005383,238583,259292,150802,149373,798050,37.614
CP003607,497813,571211,507767,479422,2056213,48.01
CP003257,302778,255510,51735,72758,682781,18.233
CP003742,234951,304049,465505,427948,1432453,62.372
CP003191,217904,251771,276710,276129,1022514,54.067
CP001397,401508,457514,162070,159107,1180199,27.214
AM260479,69132,90922,541530,485054,1186638,86.512
CP001682,86071,150480,115674,117344,469569,49.624
CP003345,516970,586170,113959,147526,1364625,19.162
CR522870,200632,315665,258426,225113,999836,48.362
CP002738,277141,321765,466949,415726,1481581,59.577
CP001616,207356,295936,240986,284210,1028488,51.065
CP000284,123259,169431,318451,283038,894179,67.267
CP002606,172159,171511,83672,100263,527605,34.862
CP008876,259772,286436,170235,203389,919832,40.619
CP009621,298317,359903,362181,376904,1397305,52.894
AP014569,60830,65775,366342,305397,798344,84.142
CP002344,34445,40990,369587,356413,801435,90.588
CP003943,561351,620590,347440,340859,1870240,36.803
CP000103,154843,194892,276430,282244,908409,61.5
CP001712,155597,170549,405929,346865,1078940,69.772
CP003390,228680,307461,183466,207932,927539,42.197
CP007445,302495,366716,98060,105414,872685,23.316
CP001968,255766,301467,212465,198917,968615,42.471
CP003778,125743,173495,644195,588779,1532212,80.47
CP002305,360023,384689,235223,239031,1218966,38.906
CP001196,87503,150894,458005,396656,1093058,78.19
